00000000000000000000
00000000000000000000
00000000000000000000
00000000000000000000
00000000000000000000
00000000000000000000
00000000111000000000
00000000141000000000
00000000101111000000
00000011120241000000
00000014023111000000
00000011112100000000
00000000014100000000
00000000011100000000
00000000000000000000
00000000000000000000
00000000000000000000
00000000000000000000
00000000000000000000
00000000000000000000