00000000000000000000
00000000000000000000
00000000000000000000
00000000000000000000
00000000000000000000
00000111110000000000
00000100310000000000
00000102210111000000
00000102010141000000
00000111011141000000
00000011000041000000
00000010001001000000
00000010001111000000
00000011111000000000
00000000000000000000
00000000000000000000
00000000000000000000
00000000000000000000
00000000000000000000
00000000000000000000
